                EX
[][][][][][][][]  []
[]        [][][]  []
[]  [][]  []  []  []
[]  [][]  []      []
[]  [][]  []  [][][]
[] $[][]  []      []
[][][][]  []  []  []
[]  [][]  []  []  []
[][][][] s[][][][][]
        EX      