[][][]EX[][][][][][]
[][][]  [][]      []
[][][]        []  []
[] $[][][][][][]  []
[]  []        []  []
[]  [][]  []  []  []
[]DD[][]  []      []
[]  [][]  []  [][][]
[]        []  [] $[]
[]  [][]  []  []  []
[][][][] s[]      []
[][][][]EX[][][][][]