                EX
[][][][][][][][]  []
[]  [][][]  [][]  []
[]  []        []  []
[]  []    []      []
[]DD[][]  []  [][][]
[]  [][]  []      []
[]        []  []  []
[]  [][]  []  []  []
[][][][] s[][][][][]
        EX      